Kimden: Leyla.Alden@gmail.com
Kime: egezeybek@yahoo.com

Konu: istanbul Semt isimlerinin Nereden Geldiðini Biliyor muydunuz


Bebek', yýlandan korkan þehzadeden 'Horhor', hor hor akan sudan geliyor


Aksaray: Fatih'in sadrazamý Ýshak Paþa, Ýç Anadolu Bölgesi'ndeki Aksaray'ý ele geçirdikten sonra orada yaþayan bölge insanlarýný bugünkü Aksaray semtinin bulunduðu yere gönderir. Aksaraylýlar da semte adlarýný verirler.
Ahýrkapý: Marmara Denizi'nin kýyýsýnda yer alan yedi ahýr kapýsýndan birisi olan bu semte, Padiþah atlarýnýn bulunduðu has ahýrýn yanýnda yer aldýðý için Ahýrkapý ismi verildi.
Aþiyan: kuþ yuvasý
Aþiyan: Günümüzdeki ismini þair Tevfik Fikret'in burada bulunan, Farsça'da kuþ yuvasý anlamýna gelen 'Aþiyan' isimli evinden alýyor.
Baðlarbaþý: Semt, en ünlü bað ve bahçelerin bir dönem burada yer almasýndan dolayý bu adla anýlýyor.
Bebek: Semtin isminin nereden geldiði konusunda iki rivayet bulunuyor. Bunlardan ilki, Fatih Sultan Mehmet'in bölgeyi korumasý için gönderdiði bölükbaþýnýn Bebek lakaplý olmasý. Diðeri ise padiþahýn semtteki bahçesinde gezerken yýlan görüp korkan þehzadesine bebek demesi ve bundan sonra bahçesinin bebek bahçesi olarak anýlmasý.
Beþiktaþ: Ýlk görüþ, semtin ismini Barbaros Hayrettin Paþa'nýn gemilerini baðlamak için diktirdiði beþ taþtan aldýðý yönünde. Diðeri ise bir papazýn burada yaptýðý kiliseye Kudüs'ten getirdiði beþik taþýný koyduðu ve ismin buradan geldiði yönünde.
 
Beyazýt: Sultan II. Beyazýt'ýn buraya kendi ismiyle anýlacak bir külliye yaptýrmasýndan sonra semt, Beyazýt olarak anýlmaya baþladý.
Beyoðlu: Semtin isminin nerden geldiði konusunda çeþitli rivayetler bulunuyor. Bunlardan ilkine göre, Ýslamiyet'i kabul edip burada oturmaya baþlayan Pontus Prensinden adýný alýyor semt. Diðerine göreyse, 'Bey Oðlu' diye anýlan Venedik Prensinin burada oturmasýndan geliyor semtin adý. Son bir rivayet de, burada oturan Venedik elçisine, yazýþmalarda, "Beyoðlu" diye hitap edilmesinden semtin bu adla anýldýðýný söylüyor.
Bakýrköy: Bizanslýlarýn 'Makri Hori' dedikleri semt, 14. yüzyýlda Osmanlýlarýn eline geçince 'Makriköy' adýný aldý. 1925'te ulusal sýnýrlar içindeki yabancý kökenli adlarýn deðiþtirilmesi sýrasýnda Atatürk'ün isteðiyle semt Bakýrköy adýný aldý.
Bostancý: Semt, adýný eskiden her türlü meyve ve sebzenin yetiþtirildiði bostanlardan biri olmasýndan alýyor.
Depremde çatlayan kapý
Çatladýkapý: Bizans zamanýnda yapýlan surlarýn Sidera adý bir verilen kapýsý, 1532 tarihinde meydana gelen depremde çatlayýnca, hem semt hem de kapý Çatladýkapý olarak anýlmaya baþladý.
Çemberlitaþ: Bizans'ýn en önemli meydanlarýndan Constantinus Forumu'nun bulunduðu yerdeki büyük sütunlardan birisi olan Çemberlitaþ, semte adýný verdi.
Çengelköy: Eskiden gemi çapalarý bu köyde yapýldýðý için isminin buradan geldiði tahmin ediliyor.
Çýksalýn: Güzel manzaralý, geniþ bir çevreye hakim olan bölgeye, halk arasýnda "çýk, salýn" denilmeye baþlandý.
 
Eminönü: Osmanlý döneminde çarþýdaki esnafý denetleme yetkisi 'Emin'lere aitti. Semt, adýný burada bulunan 'Gümrük Eminliði'nden alýyor.
Feriköy: Semt adýný Sultan Abdülmecit ve Abdülaziz dönemlerinde yaþayan Madam Feri'den alýyor. Bölgede bulunan geniþ topraklar padiþah tarafýndan Madam Feri'nin eþine baðýþlanmýþtý. Ama eþi ölünce semt onun ismiyle anýlmaya baþlandý.
Galata: Gala, Rumca da "süt" anlamýna geliyor. Bir rivayete göre Galata'nýn adý semtteki süthanelere gönderme yapýlarak türetildi. Baþka bir görüþe göre ise Ýtalyanca 'denize inen yol' anlamýna gelen 'galata' kelimesi düþünülerek bu isim verildi.
Horhor: Fatih'te bulunan semt, adýný Horhor çeþmesinden alýyor. Rivayete göre Fatih Sultan Mehmet bölge civarýnda yürürken yerin altýndan su sesleri duyar ve yanýndakilere, "Buraya bir çeþme yapýn baksanýza 'hor hor' su sesleri geliyor" der ve buraya bir çeþme yapýlýr. Çeþme de semt de Horhor ismiyle anýlmaya baþlar. 
Okmeydaný: Fetih Ordusu kuþatmanýn bir kýsmýný burada kurulan karargâhta geçirmiþ. Semtin ismi de böylelikle Okmeydaný olarak kalmýþ.
Þiþli: Þiþ yapýmýyla uðraþan ve Þiþçiler diye anýlan bir ailenin burada bir konaðý olduðu ve 'Þiþçilerin Konaðý'nýn zamanla deðiþikliðe uðrayarak 'Þiþlilerin Konaðý' hâline gelmesiyle semtin adýnýn Þiþli olarak kaldýðý anlatýlýyor.
 
Þaþkýnbakkal: Henüz yerleþimin olmadýðý dönemlerde yaz günleri denizden yararlanmak için bölgeye gelenlere bir bakkal dükkaný açýldýðýný görenler, burada iþ yapýlmayacaðýný düþünerek bakkala "þaþkýn bakkal" yakýþtýrmasý yaptýlar. Bundan sonra da semt Þaþkýnbakkal olarak anýlmaya baþlandý. 
Sütlüce: Bugün Sütlüce semtinin olduðu yerde Süt Menbat isimli bir Rum köyü vardý. Köyün bir köþesindeki bakýr bir kadýn heykelinin memelerinden su akar; bu suyun, kadýnlarýn sütünü çoðalttýðýna inanýlýrdý. Bundan dolayý semt, Sütlüce olarak anýlýr oldu.
Tahtakale: Sözlük anlamý 'kale altý' olan Taht-el-kale'nin bozulmasýyla Tahtakale'ye dönüþen semtin, Mercan ya da Beyazýt dolaylarýndaki eski sur benzeri yapýnýn aþaðý kotunda yer aldýðý için bu ismi aldýðý tahmin ediliyor.
Taksim: Osmanlý zamanýnda sucularýn; suyu, halka taksim ettikleri yer, Taksim olarak anýlmaya baþlandý.
Teþvikiye: Sultan Abdülmecit'in bir mahalle kurulmasý için teþvikte bulunduðu semtin adý Teþvikiye olarak kaldý. Bu durumu, Harbiye Karakolu ile Rumeli ve Valikonaðý Caddelerinin kesiþtiði kavþakta bulunan iki taþ belgeleliyor.
Unkapaný: Bazý satýþ yerlerinde Arapça'da 'Kabban' adýný taþýyan büyük teraziler bulunduðundan, buralarý Kapan adýný taþýrdý. Sahiline buðday ve arpa yüklü gemiler demirlediðinden, semt bu adý aldý.
Üsküdar: Bizans devrinde, Skutari denilen asker kýþlalarý, þehrin bu yakasýnda yer aldýðý için semt Skutarion diye anýlýyordu. Bu isim zamanla Üsküdar'a dönüþtü.
Veliefendi: Hipodrom bir zamanlar Þeyhülislam Veli Efendi'nin sahibi olduðu topraklar üzerinde kurulduðundan semtin adý Veli Efendi'yle anýlýyor.
9 dilde Ýstanbul

Ýstanbul'un pek çok dilde çok farklý isimleri bulunuyor.
Grekçe: Vizantion
Latince: Bizantium, Antoninya, Alma Roma, Nova Roma
Rumca: Konstantinopolis, Ýstinpolin, Megali Polis, Kalipolis
Slavca: Çargrad, Konstantingrad 
Vikingce: Miklagord
Ermenice: Vizant, Stimbol, Esdambol, Eskomboli
Arapça: Bizantiya, el-Mahsura, Kustantina el-uzma
Selçuklular zamanýnda: Konstantiniyye, Mahrusa-i Konstantiniyye, Stambul
Osmanlýca'da: Dersaadet, Deraliyye, Mahrusa-i Saltanat, Ýstanbul, Ýslambol, Darü's-saltanat-ý Aliyye, Asitane-i Aliyye, Darü'l-Hilafetü'l Aliye, Payitaht-ý Saltanat, Dergah-ý Mualla, Südde-i Saadet
L.S.I.